Im MindChat verwenden MindBroker oft folgende Abkülzungen:

* afk  = away from keyboard
* afm  = away from MindMac, aber MindPhone dabei
* bbl  = be back later
* btw  = by the way
* cu   = see you
* dfk  = dropped from keyboaaaaaaaar....
* dh   = das heißt
* dsl  = duschen shaven liften
* ftw  = for the win
* gn8  = Gute Nacht
* k    = ok
* kg   = KayGroschen
* kk   = 2x ok
* lol  = laughing out loud
* mb   = MindBroker
* mom  = einen Moment bitte
* mom, tefl= Moment, ich telefoniere gerade
* nda  = NonDisclosureAgreement
* n8   = Gute Nacht
* ofsm = off-mind-simulated: InBody mind 1 went into daily hush-maintenance mode, SecondMind took over control.
* otoh = on the other hand
* rofl = rolling on the floor laughing
* roflbtc = rolling on the floor laughing biting the carpet
* rtfw = read the f*cking wiki
* S    = StuttGart
* su   = TheSingularity
* sers = servus
* taxi = sorry, ich will keinen EheVertrag; das war nur ein OneNightStand
* tefl = wollen wir telefonieren?
* vet  = voraussichtlicher Entbindungstermin
* vlt  = vielleicht
* xoxo = hugs and kisses
* zB   = zum [Bleistift|http://www.flickr.com/photos/rainerw/464835175/]
* ;)   = smile

Denn: ZeitIstGeld ;)

Aber aus Liebe zur deutschen Sprache schreiben sie gelegentlich auch ganze deutsche Sätze.
